111111
100001
1000C1
1PC001
1C0E01
111111