111111
1P0001
1000C1
1C0001
1C0E01
111111
111111
1P0001
1000C1
1C0001
1C0E01
111111
111111
1P0001
1000C1
1C0001
1C0E01
111111