111111111
1P0C0C111
1C0000C11
1C111C111
1C000C111
1E1111111