11111111111111111
1P0C0C11111111111
1C0000C1111111111
1C111C11111111111
1C000C11111111111
1E111111111111111
11111111111111111
1P0C0C11111111111
1C0000C1111111111
1C111C11111111111
1C000C11111111111
1E111111111111111