111111111
1P0C00001
1C1110C01
1C00000C1
1C1110C01
1C0000E01
111111111